###*###
#***__#
#*#####
#*##__#
#*#####
