###_###
#_____#
#_#####
#_##__#
#_#####
