##########_#########
#_______#__#_#_____#
#_______#_____#____#
#_____#___#___#____#
#______#######_____#
#__________________#
##########_#########